111111111111111111111111111111
1EPCCCCCCCCCCCCCCCCCCCCCCCCCC1
111111111111111111111111111111
