11111111111111
10P0E0C0000001
10000000000001
10000000000001
10000000000001
10000000000001
10000000000001
10000000000001
10000000000001
10000000000001
10000000000001
10000000000001
10000000000001
10000000000001
10000000000001
10000000000001
10000000000001
10000000000001
10000000000001
10000000000001
10000000000001
10000000000001
10000000000001
10000000000001
10000000000001
10000000000001
10000000000001
10000000000001
10000000000001
10000000000001
10000000000001
10000000000001
10000000000001
10000000000001
10000000000001
10000000000001
10000000000001
10000000000001
10000000000001
10000000000001
10000000000001
10000000000001
10000000000001
10000000000001
10000000000001
10000000000001
10000000000001
10000000000001
10000000000001
10000000000001
10000000000001
10000000000001
10000000000001
10000000000001
10000000000001
10000000000001
10000000000001
10000000000001
10000000000001
10000000000001
10000000000001
10000000000001
10000000000001
10000000000001
10000000000001
10000000000001
10000000000001
10000000000001
10000000000001
10000000000001
10000000000001
10000000000001
10000000000001
10000000000001
10000000000001
10000000000001
10000000000001
10000000000001
10000000000001
10000000000001
10000000000001
10000000000001
10000000000001
10000000000001
10000000000001
10000000000001
10000000000001
10000000000001
10000000000001
10000000000001
10000000000001
10000000000001
10000000000001
10000000000001
10000000000001
10000000000001
10000000000001
10000000000001
10000000000001
10000000000001
10000000000001
10000000000001
10000000000001
10000000000001
10000000000001
10000000000001
10000000000001
10000000000001
10000000000001
10000000000001
10000000000001
10000000000001
10000000000001
10000000000001
10000000000001
10000000000001
10000000000001
10000000000001
10000000000001
10000000000001
10000000000001
10000000000001
10000000000001
10000000000001
10000000000001
10000000000001
10000000000001
10000000000001
10000000000001
10000000000001
10000000000001
10000000000001
10000000000001
10000000000001
10000000000001
10000000000001
10000000000001
10000000000001
10000000000001
10000000000001
10000000000001
10000000000001
10000000000001
10000000000001
10000000000001
10000000000001
10000000000001
10000000000001
10000000000001
10000000000001
10000000000001
10000000000001
10000000000001
10000000000001
10000000000001
10000000000001
10000000000001
10000000000001
10000000000001
10000000000001
10000000000001
10000000000001
10000000000001
10000000000001
10000000000001
10000000000001
10000000000001
10000000000001
10000000000001
10000000000001
10000000000001
10000000000001
10000000000001
10000000000001
10000000000001
10000000000001
10000000000001
10000000000001
10000000000001
10000000000001
10000000000001
10000000000001
10000000000001
10000000000001
10000000000001
10000000000001
10000000000001
10000000000001
10000000000001
10000000000001
10000000000001
10000000000001
10000000000001
10000000000001
10000000000001
10000000000001
10000000000001
10000000000001
10000000000001
10000000000001
10000000000001
10000000000001
10000000000001
10000000000001
10000000000001
10000000000001
10000000000001
10000000000001
10000000000001
10000000000001
10000000000001
10000000000001
10000000000001
10000000000001
10000000000001
10000000000001
10000000000001
10000000000001
10000000000001
10000000000001
10000000000001
10000000000001
10000000000001
10000000000001
10000000000001
10000000000001
10000000000001
10000000000001
10000000000001
10000000000001
10000000000001
10000000000001
10000000000001
10000000000001
10000000000001
10000000000001
10000000000001
10000000000001
10000000000001
10000000000001
10000000000001
10000000000001
10000000000001
10000000000001
10000000000001
10000000000001
10000000000001
10000000000001
10000000000001
10000000000001
10000000000001
10000000000001
10000000000001
10000000000001
10000000000001
10000000000001
10000000000001
10000000000001
10000000000001
10000000000001
10000000000001
10000000000001
10000000000001
10000000000001
10000000000001
10000000000001
10000000000001
10000000000001
10000000000001
10000000000001
10000000000001
10000000000001
10000000000001
10000000000001
10000000000001
10000000000001
10000000000001
10000000000001
10000000000001
10000000000001
10000000000001
10000000000001
10000000000001
10000000000001
10000000000001
10000000000001
10000000000001
10000000000001
10000000000001
10000000000001
10000000000001
10000000000001
10000000000001
10000000000001
10000000000001
10000000000001
10000000000001
10000000000001
10000000000001
10000000000001
10000000000001
10000000000001
10000000000001
10000000000001
10000000000001
10000000000001
10000000000001
10000000000001
10000000000001
10000000000001
10000000000001
10000000000001
10000000000001
10000000000001
10000000000001
10000000000001
10000000000001
10000000000001
10000000000001
10000000000001
10000000000001
10000000000001
10000000000001
10000000000001
10000000000001
10000000000001
10000000000001
10000000000001
10000000000001
10000000000001
10000000000001
10000000000001
10000000000001
10000000000001
10000000000001
10000000000001
10000000000001
10000000000001
10000000000001
10000000000001
10000000000001
10000000000001
10000000000001
10000000000001
10000000000001
10000000000001
10000000000001
10000000000001
10000000000001
10000000000001
10000000000001
10000000000001
10000000000001
10000000000001
10000000000001
10000000000001
10000000000001
10000000000001
10000000000001
10000000000001
10000000000001
10000000000001
10000000000001
10000000000001
10000000000001
10000000000001
10000000000001
10000000000001
10000000000001
10000000000001
10000000000001
10000000000001
10000000000001
10000000000001
10000000000001
10000000000001
10000000000001
10000000000001
10000000000001
10000000000001
10000000000001
10000000000001
10000000000001
10000000000001
10000000000001
10000000000001
10000000000001
10000000000001
10000000000001
10000000000001
10000000000001
10000000000001
10000000000001
10000000000001
10000000000001
10000000000001
10000000000001
10000000000001
10000000000001
10000000000001
10000000000001
10000000000001
10000000000001
10000000000001
10000000000001
10000000000001
10000000000001
10000000000001
10000000000001
10000000000001
10000000000001
10000000000001
10000000000001
10000000000001
10000000000001
10000000000001
10000000000001
10000000000001
10000000000001
10000000000001
10000000000001
10000000000001
10000000000001
10000000000001
10000000000001
10000000000001
10000000000001
10000000000001
10000000000001
10000000000001
10000000000001
10000000000001
10000000000001
10000000000001
10000000000001
10000000000001
10000000000001
10000000000001
10000000000001
10000000000001
10000000000001
10000000000001
10000000000001
10000000000001
10000000000001
10000000000001
10000000000001
10000000000001
10000000000001
10000000000001
10000000000001
10000000000001
10000000000001
10000000000001
10000000000001
10000000000001
10000000000001
10000000000001
10000000000001
10000000000001
10000000000001
10000000000001
10000000000001
10000000000001
10000000000001
10000000000001
10000000000001
10000000000001
10000000000001
10000000000001
10000000000001
10000000000001
10000000000001
10000000000001
10000000000001
10000000000001
10000000000001
10000000000001
10000000000001
10000000000001
10000000000001
10000000000001
10000000000001
10000000000001
10000000000001
10000000000001
10000000000001
10000000000001
10000000000001
10000000000001
10000000000001
10000000000001
10000000000001
10000000000001
10000000000001
10000000000001
10000000000001
10000000000001
10000000000001
10000000000001
10000000000001
10000000000001
10000000000001
11111111111111
