11111111111110
10E10000E00011
10000111110001
10011000C0P111
11111111111111
