11111111111111
100100000E0011
10000111110001
1P01100C000111
11111111111111
