11111111111111
100100000E0011
10000111110000
1P011000000111
11111111111111
