11111111111111
100100000E0011
10000111110001
1P011C00000111
11111011111111
