111111111111111111111111111111
1P10001000100010001000100010E1
101010101010101010101010101011
101010101010101010101010101011
1C1010101010101010101010101011
101010101010101010101010101011
101010101010101010101010101011
1C1010101010101010101010101011
101010101010101010101010101011
1C1010101010101010101010101011
101010101010101010101010101011
101010101010101010101010101011
101010101010101010101010101011
100010C01000100010001000100011
111111111111111111111111111111
