111111
100001
1P0CE1
100001
111111
