11111111111111
1PE10000000111
10000111110001
10111000C01111
11111111111111
