1111111111111111111111111
1P0000000C000111111111111
1000000000000111111111111
100000E0000C0111111111111
1000000000000111111111111
100000C000001111111111111
1100000000000111111111111
1000000000001111111111111
1111111000111111111111111
1111111100111111111111111
1000000000001111111111111
1110000C00001111111111111
1100000001111111111111111
1000011110000111111111111
111000C001111111111111111
1111111111111111111111111
