11111111111111
1PCCCCCCCCCC11
1CCCCCCCCCCCC1
1CCCCCECCCCCC1
1CCCCCCCCCCCC1
1CCCCCCCCCCC11
11CCCCCCCCCCC1
1CCCCCCCCCCC11
1111111CCC1111
111111111C1111
1CCCCCCCCCCC11
111CCCCCCCCC11
11CCCCCCC11111
1CCCC111100001
111CCCCCC11111
11111111111111