11111111111111
1P000000000011
10000000000001
100000E0000C01
10000000000001
100000C0000011
11000000000001
10000000000011
11111110001111
11111111101111
10000000000011
1110000C000011
11000000011111
10000111100001
111000C0011111
11111111111111
