11111111111111
10E10000000111
10000111110001
10011000C0P111
11111111111111
