1111111111111
10010000C0001
1000010111001
1P0000E000001
1111000001111
1111111111111