11111111111111
10E100P0000111
10000111110001
10111000C01111
11111111111111
